11 10
1 1 1 1 1 1 1 1 1 1
1 0 0 0 0 0 0 0 4 1
1 0 1 1 1 1 1 1 1 1
1 0 2 2 0 0 0 0 0 1
1 0 1 1 1 1 1 1 1 1
1 0 0 0 0 0 0 0 2 1
1 0 1 1 1 1 1 1 1 1
1 0 0 0 0 0 0 2 2 1
1 0 1 1 1 1 1 1 1 1
1 0 0 0 0 0 2 2 2 1
1 1 1 1 1 1 1 1 1 1
2 1 0
2 3 0
3 3 1
2 5 1
2 7 1
3 7 1
2 9 1
3 9 1
4 9 1
-
1 1 200
