11 10
0 0 0 0 0 0 0 0 0 0
0 0 0 1 1 1 1 1 0 0
0 1 1 1 0 0 0 1 0 0
0 1 2 0 0 0 0 1 0 0
0 1 1 1 0 0 2 1 0 0
0 1 2 1 1 0 0 1 0 0
0 1 0 1 0 2 0 1 1 0
0 1 0 0 2 0 0 2 1 0
0 1 0 0 0 2 0 0 1 0
0 1 1 1 1 1 1 1 1 0
0 0 0 0 0 0 0 0 0 0
2 7 0
4 7 1
5 7 0 
6 7 1
5 5 0
5 4 1
5 3 0
-
4 2 900