9 8
0 0 1 1 1 1 1 0
1 1 1 0 0 0 1 0
1 2 0 0 0 0 1 0
1 1 1 0 0 2 1 0
1 2 1 1 0 0 1 0
1 0 1 0 2 0 1 1
1 0 0 2 0 0 2 1
1 0 0 0 2 0 0 1
1 1 1 1 1 1 1 1
3 4
4 5
5 5
7 2
7 4
7 5
7 6
-
3 1