13 18
0 0 0 0 0 0 0 0 0 1 1 1 1 1 0 0 0 0
0 0 0 0 0 0 0 0 0 1 0 0 0 1 1 1 1 1
0 0 0 0 0 0 0 0 0 1 0 1 0 1 1 0 0 1
0 0 0 0 0 0 0 0 0 1 0 0 0 0 0 0 0 1
1 1 1 1 1 1 1 1 1 1 0 1 1 1 0 0 0 1
1 2 2 2 2 0 0 0 1 1 0 0 0 0 0 1 1 1
1 2 2 2 2 0 0 0 0 0 0 0 0 0 0 1 1 0
1 2 2 2 2 0 0 0 1 1 0 0 0 0 0 0 1 0
1 1 1 1 1 1 1 1 1 1 0 0 0 0 0 1 1 0
0 0 0 0 0 0 0 0 0 1 0 0 0 0 0 0 1 0
0 0 0 0 0 0 0 0 0 1 1 1 0 1 1 0 1 0
0 0 0 0 0 0 0 0 0 0 0 1 0 0 0 0 1 0
0 0 0 0 0 0 0 0 0 0 0 1 1 1 1 1 1 0
12 2 0
15 3 0
14 5 0
13 6 0
12 6 0
11 5 0
13 7 0
12 8 0
11 9 0
13 9 0
10 6 0
10 7 0
-
15 7 200