10 10
1 1 1 1 1 1 1 1 1 1
1 2 0 0 3 1 2 0 0 2
1 1 1 1 1 1 1 0 0 1
1 0 0 0 0 0 0 0 0 1
1 0 0 0 0 0 0 0 0 1
1 0 0 0 0 0 0 0 0 1
1 0 0 0 0 0 0 0 0 1
1 0 0 1 1 1 1 1 1 1
1 0 0 0 3 0 0 2 2 1
1 1 1 1 1 1 1 1 1 1
2 4 1
3 3 1
3 1 0
5 8 1
6 8 1
-
1 3 60