10 14
1 1 1 1 1 1 1 1 1 1 1 1 0 0
1 4 2 0 0 1 0 0 0 0 0 1 1 1
1 4 2 0 0 1 0 0 0 0 0 0 0 1
1 4 2 0 0 1 0 1 1 1 1 0 0 1
1 4 2 0 0 0 0 0 0 1 1 0 0 1
1 4 2 0 0 1 0 1 0 0 0 0 1 1
1 1 1 1 1 1 0 1 1 0 0 0 0 1
0 0 1 0 0 0 0 0 0 0 0 0 0 1
0 0 1 0 0 0 0 1 0 0 0 0 0 1
0 0 1 1 1 1 1 1 1 1 1 1 1 1
5 7 0 1
6 3 0 1
7 2 0
7 7 0 1
9 6 0
9 7 0
10 2 0 1
10 5 0
11 6 0 1
11 7 0
-
7 4 800