5 8
1 1 1 1 1 1 1 1 1 1
1 2 0 0 0 0 3 0 4 1
1 1 1 1 1 1 1 1 1 1
1 2 0 0 3 0 0 1 0 0
1 1 1 1 1 1 1 1 0 0
5 1 0
5 3 0
7 1 0 1
-
6 3 12